+--+--+--+--+
|p |   e    |
+  +--+--+  +
|     e     |
+--+--+  +  +
|   e    |  |
+  +--+  +  +
|     e  | g|
+--+--+--+--+
