+--+--+--+--+
|p |        |
+  +--+--+  +
|           |
+--+--+  +  +
|        |  |
+  +--+  +  +
|    e   | g|
+--+--+--+--+
