+--+-!+--+--+
|p |    3   |
+  +--+--+  +
|           |
+--+--+  +  +
|    1   |  |
+  +--+  +  +
|        |  G
+---R-Y-B+--+
|  |        @
+  +--+--+  +
|    2      |
+--+--+  +  +
|        |  #
+  +--+  +  +
|    e   |  |
+--+--+--+--+
