+--+--+--+--+
|p |    3   |
+  +--+--+  +
|           |
+--+--+  +  +
|    1   |  |
+  +--+  +  +
|        |  G
+---R-Y-B+--+
|p |        |
+  +--+--+  +
|    2      |
+--+--+  +  +
|        |  |
+  +--+  +  +
|    e   |  |
+--+--+--+--+
